1111111111
1C100C0001
1100010001
100011C001
1001001011
1P0011E0C1
1111111111