1111111111
1000P10001
1000010001
1000110001
1001001001
100011E001
1111111111