1111111111111111111111111111111111111111111111111111111
1C000C000000000000000000C0001C000C00000111C0C00000000C1
1000000000000000000000000000100000000001110000000000001
100011C00C000000100000000000100011100001110000000000001
1C000C00000011000000001110001C001C100001110000000000001
1000000000001111111110111000100010100001111111111110001
1C000C000000111111111C1110001C001C100001110000000000111
1000000000001111111110111000100010100001110111111111111
1C000C00000011111111101110001C001C100001110000000000001
1000000000001100000000001000100000000000001100000000001
1C000C00000011011100000010001C000C000001100011111111001
1000000000001100010000001000100000000001110000001110001
1C000C111111110001000000100011100C000111110000001110001
1000000000001100010000001000100000000001110000001110001
1111111111001100010000001000100111111001110000001110001
1C000C10000011000100000010001C000C000001110000001110001
1000001000001100C10000001000100000000001110000001110001
1001110000001111111111111000111111111101110000001110001
1000000000001100000100001000100000000001110000001110001
1111111000001100000100001000101111111111110000000000001
1C000C01000000000001000010001C000C000001111111111111101
101100101111000C000100001000100100000001110000000000001
1C100C00000000000001000010001C000C000001110000000000001
101100101111000C000100001000100100000001110000000000001
101100101111000C000100001000100100000001110000000000001
1P1011E0C00000000000000000000000010000011100C00000000C1
1111111111111111111111111111111111111111111111111111111