1111111111
1VVVV1VVV1
1VVVV1VVV1
1VVVV1VVV1
1VVVVV1VV1
1PVVV1EVV1
1111111111