1111111
100C001
1001001
10010C1
1P01001
1111111