1111111
1001001
1001001
100C001
1001001
1P010E1
1111111