1111111111111
1E000000000C1
1000001000001
1000001011111
1C00001000001
1P000010000C1
1111111111111