1111111111111
1E000000000C1
100e001000001
1000001011111
1Ce0001000001
1P0e001e000C1
1111111111111